NO  ./img/NO.png
SO ./img/SO.png
WE ./img/WE.png
EA ./img/EA.png
F 120,124,120
C 60,60,60

    111
1111101111111111
1000000000000001
1000000000000001
1000100000000001
1000100000S00001
1000100000000001
1000100000000001
1000000000000001
1111111111111111