NO ./img/NO.png
SO ./img/SO.png
EA ./img/EA.png
WE ./img/WE.png
F 120,123,129
C 120,124,120

1111111111111111
1000000000000001
1000000000000111
1000100000000001
1111000000S00001
   1000100000011111
   1000100000000001
   1000000000000001
   1111111000000001
        1000100000111111
        1000100000000001
        1000000000000001
        1111111111111111