C 50,100,230
F 100,230,50
NO ./img/grass.png
SO ./img/wood.png
WE ./img/brick.png
EA ./img/chino.png

1111111111111111111111
1000000000100000000001
1000100000100010000001
1000100000100010000001
1000100000100010001001
1000100000100010001001
1000100000100010001001
1000100000100010001001
1000100000100010001001
1000000000100000000001
1000000000000000000001
1111111110N01111111111
1000000000000000000001
1000000000100000000001
1000100100100100000001
1000100100100100000001
1000100100100100000001
1000100100100100000001
1000100100100100000001
1000100100100101111111
1000100100100100000001
1000000000100000000001
1111111111111111111111