NO ./img/NO.png
SO ./img/SO.png
WE ./img/WE.png
EA ./img/EA.png

F 180,180,0
C 180,0,0

1111111111111111
1S00000000000001
1000000000000001
1000000000000001
1000000000000001
1000000000000001
1000000000000001
1000000000000001
1111111111111111