NO ./img/grass.png
SO ./img/wood.png
WE ./img/brick.png
EA ./img/chino.png

C 135, 206, 235
F 60,60,60

1111111111111111
1000000000000001
1000000110000001
1000100000000001
1000100000000001
1000100000000001
1000100N00000001
1000000000000001
1111111111111111