NO ./img/NO.png
SO ./img/SO.png
WE ./img/WE.png
EA ./img/EA.png

F 190,0,0
C 190,0,0

1111111111111111
1000000000000001
1000000000000001
1000100000000001
1000100N00000001
1000100000000001
1000100000000001
1000000000000001
1111111111111111